1 1 1 4 5 1 7
1 1 0 0 4 5 7
1 1 0 0 1 1 7
1 2 3 2 1 1 7
1 2 3 4 5 6 7